111111
1CPEC1
101111
10CCC1
111111
111111