11111111111111111111111111111111111111
1CCCCCCCCCCCCCCCCCGCCCCCCCCCCCCCCCCCC1
1CCCCCCCCCCCC1111111C111111111111111C1
1CCCCCCCCC11111111CCC1111CCC11111111C1
1CCCCCCC1111111CCCCCC1C1CCCC11111111C1
1CCCC11111111CCCCCCCC1CCCCCC1111111CC1
1CC1110111CCCCCCC0CCCCCCC11111111CCCC1
1C111111CCCCCCCCCCCCCCC1111111CCCCCCC1
1C1111CCCCCCC1CCCCCGC1111111CCCCCCCCC1
1C111111111111111111C1101111CCCCC111C1
1C111111111111111111C1111111CCC11111C1
1C111111111111111111C1111111C1111111C1
1CGCCCCCCCCCC1111111PCCCCCCCCCCCCCCCC1
1CCCCCCCCCCCC1111111C11CCCCCCCCCCCCCC1
1CCCCCCCCCCCC1111111C1111111111111CCC1
10CCCCCCCCCCC1111111CCCGCCCCCCCCCCC0E1
11111111111111111111111111111111111111