11111111111111111111111111111111111111
1CCCCCCCCCCCCCCCCCCCCCCCCCCCCCCCCCCCC1
1C0111111100000000000111111111111111C1
1C1111111100000000000111111111111111C1
1C1111111100000G00000111111111111111C1
1C1100001100000000000000000000001111C1
1C1100001100000000000000000000001111C1
1C0000001100000000000000000000001111C1
1C00000011000000E0000000G00000001111C1
1C0000001100000000000011000000001111C1
1C0000001100000000000011111111111110C1
1C0000001100000000000011111111001111C1
1C00000000000000000P0000000000001111C1
1C0000001100000000000000000000001111C1
1C000000110000000000000C0000G0001111C1
1C0000001100000000000000000000001111C1
1C0001111111100000000111111111111111C1
1C0001111111100000000111111111111111C1
1C0001111111100000000111111111111111C1
1CCCCCCCCCCCCCCCCCCCCCCCCCCCCCCCCCCCC1
11111111111111111111111111111111111111