1111111111111
1C000E0P000C1
1111111111111
10000000000G1
1111111111111